{
  "version": 1,
  "notes": "",
  "documentation": "\"This file is a QMK Configurator export. You can import this at <https://config.qmk.fm>. It can also be used directly with QMK's source code.\n\nTo setup your QMK environment check out the tutorial: <https://docs.qmk.fm/#/newbs>\n\nYou can convert this file to a keymap.c using this command: `qmk json2c {keymap}`\n\nYou can compile this keymap using this command: `qmk compile {keymap}`\"\n",
  "keyboard": "ferris/sweep",
  "keymap": "sweeper_001",
  "layout": "LAYOUT_split_3x5_2",
  "layers": [
    [
      "KC_W",
      "KC_L",
      "KC_R",
      "KC_B",
      "KC_Z",
      "KC_SCLN",
      "KC_Q",
      "KC_U",
      "KC_D",
      "KC_J",
      "KC_S",
      "LALT_T(KC_H)",
      "LGUI_T(KC_N)",
      "LCTL_T(KC_T)",
      "KC_COMM",
      "KC_DOT",
      "RCTL_T(KC_A)",
      "RGUI_T(KC_E)",
      "RALT_T(KC_O)",
      "KC_I",
      "KC_F",
      "KC_M",
      "KC_V",
      "KC_C",
      "KC_SLSH",
      "KC_G",
      "KC_P",
      "KC_X",
      "KC_K",
      "KC_Z",
      "OSM(MOD_LSFT)",
      "TG(2)",
      "TG(1)",
      "KC_SPC"
    ],
    [
      "KC_GRV",
      "KC_TRNS",
      "KC_LCBR",
      "KC_RCBR",
      "KC_TILD",
      "KC_EQL",
      "KC_DLR",
      "KC_PERC",
      "KC_CIRC",
      "KC_BSPC",
      "KC_ESC",
      "KC_PIPE",
      "KC_LPRN",
      "KC_RPRN",
      "KC_PLUS",
      "KC_MINS",
      "KC_EXLM",
      "KC_AT",
      "KC_HASH",
      "KC_QUOT",
      "KC_DEL",
      "KC_TRNS",
      "KC_LBRC",
      "KC_RBRC",
      "KC_BSLS",
      "KC_UNDS",
      "KC_AMPR",
      "KC_ASTR",
      "KC_DQUO",
      "KC_ENT",
      "CW_TOGG",
      "TG(0)",
      "TG(3)",
      "KC_TRNS"
    ],
    [
      "KC_TRNS",
      "KC_TRNS",
      "KC_TRNS",
      "KC_TRNS",
      "KC_TRNS",
      "KC_TRNS",
      "KC_7",
      "KC_8",
      "KC_9",
      "KC_TRNS",
      "KC_TRNS",
      "KC_TRNS",
      "KC_TRNS",
      "KC_TRNS",
      "KC_TRNS",
      "KC_MINS",
      "KC_4",
      "KC_5",
      "KC_6",
      "KC_TRNS",
      "KC_TRNS",
      "KC_TRNS",
      "KC_TRNS",
      "KC_TRNS",
      "KC_TRNS",
      "KC_0",
      "KC_1",
      "KC_2",
      "KC_3",
      "KC_TRNS",
      "KC_TRNS",
      "TG(0)",
      "KC_TRNS",
      "KC_SPC"
    ],
    [
      "KC_F1",
      "KC_F2",
      "KC_F3",
      "KC_F4",
      "KC_F5",
      "KC_F6",
      "KC_F7",
      "KC_F8",
      "KC_F9",
      "KC_F10",
      "KC_F12",
      "KC_LALT",
      "KC_LGUI",
      "KC_LCTL",
      "KC_F11",
      "KC_LEFT",
      "KC_DOWN",
      "KC_UP",
      "KC_RGHT",
      "KC_TAB",
      "KC_ESC",
      "KC_TRNS",
      "KC_TRNS",
      "KC_TRNS",
      "KC_TRNS",
      "KC_HOME",
      "KC_PGDN",
      "KC_PGUP",
      "KC_END",
      "LSFT(KC_TAB)",
      "KC_LSFT",
      "TG(0)",
      "KC_TRNS",
      "KC_TRNS"
    ],
    [
      "KC_TRNS",
      "KC_TRNS",
      "KC_TRNS",
      "KC_TRNS",
      "KC_TRNS",
      "KC_TRNS",
      "KC_TRNS",
      "KC_TRNS",
      "KC_TRNS",
      "KC_TRNS",
      "KC_TRNS",
      "KC_TRNS",
      "KC_TRNS",
      "KC_TRNS",
      "KC_TRNS",
      "KC_TRNS",
      "KC_TRNS",
      "KC_TRNS",
      "KC_TRNS",
      "KC_TRNS",
      "KC_TRNS",
      "KC_TRNS",
      "KC_TRNS",
      "KC_TRNS",
      "KC_TRNS",
      "KC_TRNS",
      "KC_TRNS",
      "KC_TRNS",
      "KC_TRNS",
      "KC_TRNS",
      "KC_TRNS",
      "KC_TRNS",
      "KC_TRNS",
      "KC_TRNS"
    ],
    [
      "KC_TRNS",
      "KC_TRNS",
      "KC_TRNS",
      "KC_TRNS",
      "KC_TRNS",
      "KC_TRNS",
      "KC_TRNS",
      "KC_TRNS",
      "KC_TRNS",
      "KC_TRNS",
      "KC_TRNS",
      "KC_TRNS",
      "KC_TRNS",
      "KC_TRNS",
      "KC_TRNS",
      "KC_TRNS",
      "KC_TRNS",
      "KC_TRNS",
      "KC_TRNS",
      "KC_TRNS",
      "KC_TRNS",
      "KC_TRNS",
      "KC_TRNS",
      "KC_TRNS",
      "KC_TRNS",
      "KC_TRNS",
      "KC_TRNS",
      "KC_TRNS",
      "KC_TRNS",
      "KC_TRNS",
      "KC_TRNS",
      "KC_TRNS",
      "KC_TRNS",
      "KC_TRNS"
    ],
    [
      "KC_TRNS",
      "KC_TRNS",
      "KC_TRNS",
      "KC_TRNS",
      "KC_TRNS",
      "KC_TRNS",
      "KC_TRNS",
      "KC_TRNS",
      "KC_TRNS",
      "KC_TRNS",
      "KC_TRNS",
      "KC_TRNS",
      "KC_TRNS",
      "KC_TRNS",
      "KC_TRNS",
      "KC_TRNS",
      "KC_TRNS",
      "KC_TRNS",
      "KC_TRNS",
      "KC_TRNS",
      "KC_TRNS",
      "KC_TRNS",
      "KC_TRNS",
      "KC_TRNS",
      "KC_TRNS",
      "KC_TRNS",
      "KC_TRNS",
      "KC_TRNS",
      "KC_TRNS",
      "KC_TRNS",
      "KC_TRNS",
      "KC_TRNS",
      "KC_TRNS",
      "KC_TRNS"
    ],
    [],
    [],
    [],
    [],
    [],
    [],
    [
      "KC_TRNS",
      "KC_TRNS",
      "KC_TRNS",
      "KC_TRNS",
      "KC_TRNS",
      "KC_TRNS",
      "KC_TRNS",
      "KC_TRNS",
      "KC_TRNS",
      "KC_TRNS",
      "KC_TRNS",
      "KC_TRNS",
      "KC_TRNS",
      "KC_TRNS",
      "KC_TRNS",
      "KC_TRNS",
      "KC_TRNS",
      "KC_TRNS",
      "KC_TRNS",
      "KC_TRNS",
      "KC_TRNS",
      "KC_TRNS",
      "KC_TRNS",
      "KC_TRNS",
      "KC_TRNS",
      "KC_TRNS",
      "KC_TRNS",
      "KC_TRNS",
      "KC_TRNS",
      "KC_TRNS",
      "KC_TRNS",
      "KC_TRNS",
      "KC_TRNS",
      "KC_TRNS"
    ]
  ],
  "author": ""
}
